15 x 30
******************************
*   *               R        *
*    R     *                 *
*            +           *   *
*                 *          *
*  *      +*   H             *
*     *            +     R   *
*           *            *   *
*   R              *         *
*       *                    O
*  +            R      +     *
*        R     +             *
*    *            *     *    *
*          *         R       *
******************************