15 x 30
******************************
*   *               R        *
*          *       R         *
*            +           *   *
*      r          *          *
*  *      **             R   *
*     *        H   *     R   *
*           *            *   *
*   R              *         *
*       *                    O
*  *            R      *     *
*        R     *             *
*    *            *     *    *
*          *         R       *
******************************