15 x 30
******************************
*   *               R        *
*    R     *                 *
*                        *   *
*                 *          *
*  *      **   H             *
*     *            *     R   *
*           *            *   *
*   R              *         *
*       *                    *
*  *            R      *     *
*        R     *             *
*    *            *     *    *
*          *         R       *
******************************